7 7 3
# # # # # . .
# . . . # # #
# . * . O O #
# . * * . X #
# # . . . # #
. # . O . # .
. # # # # # .