6 12 4
. # # # # . . # # # # #
# # . . # . . # . . . #
# . * . # # # # * . . #
# . . * O O O O . * . #
# # . . . . # . X . # #
. # # # # # # # # # # .