9 9 3
# # # # # . . . .
# . . . # . . . .
# . * . # . # # #
# . * . # . # O #
# # # . # # # O #
. # # . . . . O #
. # . * . # . . #
. # X . . # # # #
. # # # # # . . .