6 7 3
# # # # # . .
# . . . # # #
# . . * O O #
# . * * O X #
# # . . . # #
. # # # # # .