8 12 4
. . # # # . . .
. . # O # . . .
. . # . # # # #
# # # * . * O #
# O . * X # # #
# # # # * # . .
. . . # O # . .
. . . # # # . .