9 9 1
. # # # # # # # .
# # . # . . . # #
# . X # O . . . #
# . . # # # . . #
# . . # # # . . #
# . . * . # . . #
# . . . . . . . #
# # . . # . . . #
. # # # # # # # #