8 8 1
. . # # # # # .
# # # . . . # .
# . * . # . # #
# . # . . O . #
# . . . . # . #
# # . # . . . #
. # X . . # # #
. # # # # # . .